{
  "width": 28,
  "height": 31,
  "tiles": [
    [1,1,1,1,1,1,1,1,1,1,1,1,1,1,1,1,1,1,1,1,1,1,1,1,1,1,1,1],
    [1,2,2,2,2,2,2,2,2,2,2,2,2,1,1,2,2,2,2,2,2,2,2,2,2,2,2,1],
    [1,2,1,1,1,1,2,1,1,1,1,1,2,1,1,2,1,1,1,1,1,2,1,1,1,1,2,1],
    [1,3,1,1,1,1,2,1,1,1,1,1,2,1,1,2,1,1,1,1,1,2,1,1,1,1,3,1],
    [1,2,1,1,1,1,2,1,1,1,1,1,2,1,1,2,1,1,1,1,1,2,1,1,1,1,2,1],
    [1,2,2,2,2,2,2,2,2,2,2,2,2,2,2,2,2,2,2,2,2,2,2,2,2,2,2,1],
    [1,2,1,1,1,1,2,1,1,2,1,1,1,1,1,1,1,1,2,1,1,2,1,1,1,1,2,1],
    [1,2,1,1,1,1,2,1,1,2,1,1,1,1,1,1,1,1,2,1,1,2,1,1,1,1,2,1],
    [1,2,2,2,2,2,2,1,1,2,2,2,2,1,1,2,2,2,2,1,1,2,2,2,2,2,2,1],
    [1,1,1,1,1,1,2,1,1,1,1,1,0,1,1,0,1,1,1,1,1,2,1,1,1,1,1,1],
    [0,0,0,0,0,1,2,1,1,1,1,1,0,1,1,0,1,1,1,1,1,2,1,0,0,0,0,0],
    [0,0,0,0,0,1,2,1,1,0,0,0,0,0,0,0,0,0,0,1,1,2,1,0,0,0,0,0],
    [0,0,0,0,0,1,2,1,1,0,1,1,1,5,5,1,1,1,0,1,1,2,1,0,0,0,0,0],
    [1,1,1,1,1,1,2,1,1,0,1,4,4,4,4,4,4,1,0,1,1,2,1,1,1,1,1,1],
    [0,0,0,0,0,0,2,0,0,0,1,4,4,4,4,4,4,1,0,0,0,2,0,0,0,0,0,0],
    [1,1,1,1,1,1,2,1,1,0,1,4,4,4,4,4,4,1,0,1,1,2,1,1,1,1,1,1],
    [0,0,0,0,0,1,2,1,1,0,1,1,1,1,1,1,1,1,0,1,1,2,1,0,0,0,0,0],
    [0,0,0,0,0,1,2,1,1,0,0,0,0,0,0,0,0,0,0,1,1,2,1,0,0,0,0,0],
    [0,0,0,0,0,1,2,1,1,0,1,1,1,1,1,1,1,1,0,1,1,2,1,0,0,0,0,0],
    [1,1,1,1,1,1,2,1,1,0,1,1,1,1,1,1,1,1,0,1,1,2,1,1,1,1,1,1],
    [1,2,2,2,2,2,2,2,2,2,2,2,2,1,1,2,2,2,2,2,2,2,2,2,2,2,2,1],
    [1,2,1,1,1,1,2,1,1,1,1,1,2,1,1,2,1,1,1,1,1,2,1,1,1,1,2,1],
    [1,2,1,1,1,1,2,1,1,1,1,1,2,1,1,2,1,1,1,1,1,2,1,1,1,1,2,1],
    [1,3,2,2,1,1,2,2,2,2,2,2,2,6,6,2,2,2,2,2,2,2,1,1,2,2,3,1],
    [1,1,1,2,1,1,2,1,1,2,1,1,1,1,1,1,1,1,2,1,1,2,1,1,2,1,1,1],
    [1,1,1,2,1,1,2,1,1,2,1,1,1,1,1,1,1,1,2,1,1,2,1,1,2,1,1,1],
    [1,2,2,2,2,2,2,1,1,2,2,2,2,1,1,2,2,2,2,1,1,2,2,2,2,2,2,1],
    [1,2,1,1,1,1,1,1,1,1,1,1,2,1,1,2,1,1,1,1,1,1,1,1,1,1,2,1],
    [1,2,1,1,1,1,1,1,1,1,1,1,2,1,1,2,1,1,1,1,1,1,1,1,1,1,2,1],
    [1,2,2,2,2,2,2,2,2,2,2,2,2,2,2,2,2,2,2,2,2,2,2,2,2,2,2,1],
    [1,1,1,1,1,1,1,1,1,1,1,1,1,1,1,1,1,1,1,1,1,1,1,1,1,1,1,1]
  ]
}
